11111111111111111111
100000P00000000000C1
10000000000000000001
10000000000000000001
10000C00000000000001
100000000000000000E1
111111111111111111111
